XXXXXXXXXXXX
X         XX
X XXX XXXXXX
X   X     XX
X XXXXX XXXX
X     X XXXX
X XXXXXXXXXX
XS    X    X
X X XXX XX  
X X XXX   XX
XXX       XX
XXXXXXXXXXXX 