XXXXXXXXXXX
XX    S   X
X X   XX XX
X X XXXX XX
X X   X  XX
X X XX   XX
X     X XXX
X XXX     X
X    XXXX X
X XXXXXXXXX 