XXXXXXXXXXXXXXXXXXXXXXXX
X X    XXXXXXX        XX
X X XXX X    X XXXXXX XX
X       X XX X  XXXXX XX
X XX XX X X  XX XXXXX XX
XX    X   X  X    XXX XX
X X   X X X  X XX XXX XX
X   X  X  X  X X  XXX XX
X X  XX  XX  X X XXXX XX
X X  X  X X XX X    X XX
X XXXX  X   X   XXX  XXX
X    X  X   X XXXXXX  XX
XX XXX  X  X  X  XXXX  X
X    X  X            X X
X XX X  XXXXX    XXXX  X
X X  X       XXXXX      
X X X            X     X
XSXXXXXXXXXXXXXXXXXXXXXX
XXXXXXXXXXXXXXXXXXXXXXXX