XXXXXXXXXXXXX
X          XX
X X     XXXXX
X X XXXXXXXXX
XS      XXXXX
X X XXXXXXXXX
X X     XX XX
XXX XXXXX  XX
X         XXX
X X X XXXXXXX
X   X     XXX
XXXXXXX XXXXX 
