XXXXXXXXXX
X X XXXXXX
X X XXXXEX
X X X X XX
X X X X XX
XS      XX
X X X X XX
X X X X XX
XXXXXXXXXX
XXXXXXXXXX