XXXXXXXXXX
XS      XX
X X XXXXXX
X X X   XX
XXX X XXXX
X   X     
X X X XXXX
X X X XXXX
X X    XXX
XXXXXXXXXX 