XXXXXXXXXXXXXXXXXX
XXXXXXXXXXXXXXXXXX
X   X X X X XXXXXX
X XXX X X X XXXXXX
X X X   X     XXXX
X X X XXX XXXXXXXX
X           XXXXXX
X XXX X X XXXXXXXX
XS  X X X XXXXXXXX
X XXX XX         
X   X   XXXXXXXXXX
X XXX XXXXXXXXXXXX
X X     XXXXXXXXXX
XXXXX XXXXXXXXXXXX
XXX       XXXXXXXX
XXXXX X XXXXXXXXXX
XXXXX X   XXXXXXXX
XXXXXXXXXXXXXXXXXX