XXXXXXXXXXXXXXXXXXXXXXXXXXXXXXXXXXXXXXXXXXXXXXXXXXXXXXXXXXXXXXXXXXXXXXXXXXXXXXXXXXXXXXXXXXXXXXXXXXXX
X X     X       X     X X X   X X X X     X X     X X X X X     X X   X X   X X X X X X X X     X XX
X XXX XXX XXXXXXX XXXXX X X XXX X X X XXXXX XXXXX X X X X X XXXXX XXX X X XXX X X X X X X X XXXXX XX
X     X X     X X   X   X X   X     X   X                       X   X X               X       X   XX
XXXXX X X XXXXX X XXX XXX X XXXXX XXX XXXXXXXXXXXXXXX XXXXXXXXXXX XXX X XXXXXXXXXXXXXXX XXX XXX XXXX
X X   X     X X     X X X     X   X X X X X   X X X   X X   X X X X         X X           X   X   XX
X XXX X XXXXX XXX XXX X X XXXXXXX X X X X XXX X X XXX X X XXX X X X XXXXXXXXX X XXXXX X XXXXXXX XXXX
X     X X X X   X     X     X X X X   X   X X X   X     X X X X X X     X           X X       X X XX
XXXXX X X X X XXX XXXXX XXXXX X X X XXX XXX X XXX XXXXX X X X X X X XXXXX XXXXXXXXXXXXXXX XXXXX X XX
X     X X           X X X X X         X X X   X   X X X X   X         X X   X X X     X X   X X X XX
XXXXX X X XXXXXXXXXXX X X X XXX XXX XXX X X XXXXX X X X X XXX XXXXXXXXX X XXX X X XXXXX XXXXX X X XX
X X     X X X X X   X   X     X X     X   X X X   X         X X X X                 X X   X   X   XX
X XXXXX X X X X X XXXXX X XXXXXXXXX XXX XXX X XXX XXX XXX XXX X X X XXX XXXXXXXXXXXXX X XXXXX XXX EX
X X X X         X   X   X X X X     X   X X   X       X               X X X X X           X X     XX
X X X X XXXXXXXXX XXXXX X X X XXXXX XXX X X XXXXXXXXXXXXX XXX X XXXXXXXXX X X X XXXXX XXXXX XXXXX XX
X         X X X X X X X X   X   X X X     X X X X X X       X X       X   X X     X X   X X   X   XX
X XXX XXXXX X X X X X X XXX X XXX X XXXXX X X X X X XXXXX XXXXX X XXXXXXX X X XXXXX XXXXX X XXXXX XX
X X X X X     X X X     X X   X X     X X     X     X         X X X X X X X     X X   X       X X XX
X X XXX XXX XXX X X XXXXX XXX X X XXXXX X XXXXX XXXXX XXX XXXXXXXXX X X X X XXXXX X XXXXX XXXXX X XX
X     X X X X X X     X   X   X X   X     X X X X X X X   X X   X X   X X X       X   X   X X X   XX
X XXXXX X X X X X XXXXXXX XXX X X XXXXXXX X X X X X XXXXX X X XXX X XXX X X XXXXXXX XXXXX X X X XXXX
X X   X   X X X     X X X X   X     X     X X   X     X X     X X X   X         X X X X   X   X   XX
X X XXXXX X X X XXXXX X X XXX X XXXXXXXXX X XXX X XXXXX X XXXXX X X XXX XXX XXXXX X X XXX X XXX XXXX
X   X X     X X   X X   X X   X   X X X     X X X   X X       X           X     X X X   X         XX
X XXX XXXXX X X XXX X XXX XXX X XXX X XXXXX X X X XXX X XXXXXXX XXXXX X XXXXXXXXX X X XXX XXXXXXX XX
X   X X X     X X X X   X X X       X X X X   X X       X X       X X X X X X   X X     X       X XX
X XXX X XXXXX X X X X XXX X X XXX XXX X X XXX X X XXX XXX X XXXXXXX XXXXX X X XXX X XXXXX XXXXXXXXXX
X X X X X         X X   X   X   X X X X   X         X         X       X         X X     X   X X X XX
X X X X XXXXXXX XXX X XXX XXX XXXXX X XXX XXX XXX XXXXX XXX XXX XXXXXXXXXXX XXXXX X XXXXX XXX X X XX
X X     X X X     X X     X X   X X   X   X X   X     X   X   X     X X X X X         X X   X     XX
X XXX XXX X XXX XXX X XXXXX X XXX X XXXXX X X XXX X XXXXXXXXXXX XXXXX X X X X XXXXX XXX X XXX XXX XX
X X   X X   X X   X     X X X X       X         X X     X X X         X     X     X             X XX
X XXX X XXX X X XXX XXXXX X X X XXX XXXXXXX XXXXXXX XXXXX X X XXX X X X XXX X XXXXXXXXX XXXXXXXXX XX
X   X X X X       X       X X     X X X   X   X   X             X X X X X       X     X     X   X XX
XXX X X X XXX XXXXX XXXXXXX X XXXXXXX XXX X XXX XXX X XXXXX X XXXXXXX XXXXXXX XXX XXXXXXX XXX XXXXXX
X   X             X X   X       X X   X X X       X X X X X X   X   X X X X X         X X       X XX
XXX XXXXXXXXX XXXXX X XXXXX XXXXX XXX X X X XXXXXXXXXXX X XXXXXXX XXXXX X X X XXXXXXXXX XXXXX XXX XX
X X   X   X   X X   X X X   X X X X X     X X X X X X       X X   X X X   X           X     X     XX
X X XXXXX XXX X XXX X X XXX X X X X X XXXXX X X X X XXX XXXXX XXX X X XXX X XXXXX X XXX XXX XXX XXXX
X     X X X   X   X   X X X       X X X X   X X   X X X     X X X X X   X       X X       X   X   XX
XXX XXX X XXX X XXXXX X X X XXXXXXX X X XXX X X XXX X X XXXXX X X X X XXX XXXXXXXXXXXXX XXXXX X XXXX
X     X X X   X   X             X       X   X     X X X X   X     X X   X X           X X   X X X XX
XXX XXX X XXX X XXXXX XXX XXXXXXXXX XXXXXXX X XXXXX X X X XXXXX XXX X XXX X XXXXXXXXXXXXX XXXXXXX XX
X   X X X   X       X X       X   X   X X                 X X X X X             X             X   XX
XXX X X X XXXXX XXXXXXXXX XXXXXXX X XXX XXXXX XXXXXXXXXXXXX X X X X XXXXX X XXXXX XXX X X XXXXXXX XX
X X   X   X X X X   X X     X X X X   X X X X   X X X   X X   X         X X         X X X X X X   XX
X XXX X XXX X X X XXX XXX XXX X X X XXX X X X XXX X X XXX X XXX XXX XXXXXXX XXXXX XXXXXXXXX X XXX XX
X X   X X           X       X   X X   X X X                   X X X     X X     X   X   X     X X XX
X XXX X XXX XXX XXXXXXXXX XXX XXX X XXX X X XXX XXX XXXXXXX XXX X XXXXXXX XXX XXXXXXXXX XXXXX X X XX
X X   X X X   X X X X X   X X X X     X       X   X       X X X X     X     X     X X X   X X     XX
X XXX X X X XXXXX X X XXX X X X X XXXXX XXXXX X XXX X X XXXXX X X XXXXXXX XXXXXXXXX X X XXX X XXXXXX
X             X         X X     X   X X     X X   X X X X X         X X X     X X     X X X     X XX
XXXXXXXXX XXXXXXX XXXXXXX XXX XXX XXX X XXXXXXX XXXXXXXXX X XXXXXXXXX X X XXXXX X XXXXX X X XXXXX XX
X X X X       X X X X X   X X X     X X   X   X X                 X         X X   X X X X       X XX
X X X XXX XXXXX X X X XXX X X X XXXXX X XXX XXXXX XXXXXXX X X X XXX XXXXXXXXX X XXX X X X XXXXXXX XX
X   X X   X X X   X X X X X X   X X   X                 X X X X X     X   X                     X XX
X XXX XXX X X XXX X X X X X X XXX X XXX XXX XXX XXXXXXXXXXXXXXXXXXX XXX XXX XXXXXXX XXXXX XXXXXXX XX
X X X X X   X X X   X   X X           X   X   X X X       X   X X                 X     X   X X X XX
X X X X X XXX X X XXXXX X X XXXXX X XXX XXX XXXXX X XXXXXXX XXX XXX XXXXXXXXXXXXXXXXXXXXX XXX X X XX
X     X     X     X X       X X X X       X X   X         X X X X X         X       X X X X       XX
XXX XXX XXXXX XXXXX XXXXX XXX X XXXXX X XXXXX XXX XXX XXXXX X X X X XXXXX XXX XXX XXX X XXX XXXXXXXX
X   X X   X X   X   X X     X X     X X             X                   X       X     X   X   X X XX
XXX X X XXX X XXXXX X XXX XXX X XXX XXX XXXXXXXXXXXXX XXX X X X XXX XXXXX X X XXXXXXXXX XXX XXX X XX
X     X X X   X X X   X           X X               X   X X X X   X     X X X     X X X X X       XX
XXX XXX X X XXX X X XXXXX XXX X XXXXX X X XXX XXXXXXXXXXXXXXXXX XXX XXXXX X X XXXXX X X X X XXXXX XX
X X   X     X X X   X X X   X X     X X X   X       X   X X X X X X     X X X                   X XX
X X XXX XXXXX X X XXX X X XXX XXXXXXXXX X X X X X XXX XXX X X XXX XXXXXXX XXX X XXXXX XXXXX X XXXXXX
X X   X X X X               X     X X   X X X X X X X   X               X   X X     X     X X     XX
X X XXX X X XXX XXX X X X XXX XXXXX XXXXXXXXXXXXXXX X XXX XXXXXXXXXXXXXXX XXX X X XXX X XXXXX X X XX
X     X X X   X   X X X X   X   X X X X X     X X X                     X   X X X   X X X X X X X XX
X XXXXX X X XXX XXXXX XXX XXXXXXX X X X X XXXXX X X XXXXXXX XXX XXXXXXXXXXX X X X X XXXXX X XXXXXXXX
X   X X             X   X   X X X X     X   X X           X X X X X X     X X X X X           X X XX
X XXX X XXXXXXXXXXXXXXXXXXXXX X X X XXXXX XXX XXXXX XXXXXXXXX XXX X X XXXXX XXX X X X XXXXX XXX X XX
XS                                            X X X   X                   X X   X X X     X       XX
X XXX X X X X X X X X X XXX X X XXX X XXXXXXXXX X X XXX XXXXX X X X X X XXXXX X XXXXX X XXX X X XXXX
X   X X X X X X X X X X   X X X   X X     X X X X           X X X X X X X X X X X     X X   X X   XX
X XXXXXXXXXXX XXX X XXX XXX XXXXXXXXX X XXX X X X XXX X XXXXXXXXXXXXX XXX X XXXXXXX X X X X X X X XX
X           X X X X   X   X         X X             X X       X     X       X   X X X X X X X X X XX
X X XXX X XXXXX XXXXXXX X X X XXX X X X X X X X X XXXXX XXXXXXX XXXXX X X XXX XXX XXXXXXX X X XXXXXX
X X   X X     X       X X X X   X X X X X X X X X     X           X X X X     X X     X X X X     XX
XXX X X X X XXX XXXXXXX X X X XXXXXXXXXXX XXXXXXXXX XXXXXXXXXXXXXXX XXXXX X XXX X XXXXX XXXXX X X XX
X   X X X X           X X X X     X   X           X                   X X X X X       X   X X X X XX
X X XXX XXX X X X XXXXXXXXX XXX XXX XXX X X XXXXXXXXX X XXXXXXX XXXXXXX XXXXX X XXXXXXX XXX XXXXX XX
X X X     X X X X         X   X       X X X         X X       X   X       X X                   X XX
X XXXXX XXXXX X X XXXXXXX X X X XXX XXXXXXX XXXXXXXXXXXXX X XXX XXX XXX XXX X XXXXXXXXXXXXX XXXXX XX
X X       X   X X     X X X X X   X   X                 X X   X       X                   X   X X XX
XXXXX X XXXXX XXX X XXX XXX X X XXXXXXXXX X X X X XXXXXXXXX X X X XXXXX X XXX XXX XXX XXXXX XXX XXXX
X     X   X X X   X       X X X       X   X X X X     X X X X X X     X X   X   X   X     X       XX
X X X X XXX XXXXX X X X XXXXXXX XXXXXXXXX X XXXXX XXXXX X XXXXXXX XXXXXXX XXX XXX XXX X X X X X XXXX
X X X X         X X X X     X           X X     X             X       X X   X   X   X X X X X X   XX
XXX X X X XXXXXXXXX X X XXXXX X XXX X XXXXX X X XXXXX X X X XXXXX XXXXX XXXXX XXX XXX XXXXX XXXXXXXX
X   X X X     X   X X X   X   X   X X X   X X X     X X X X   X     X X     X   X   X     X       XX
X X XXXXX XXXXX XXX X XXXXXXX X XXXXXXX XXXXXXX XXXXXXXXXXX XXXXX XXX X XXXXXXXXX XXX XXXXX X X XXXX
X X X             X X       X X   X         X X X         X   X             X   X   X     X X X     
XXX XXXXX XXXXX XXXXX X X XXXXX XXX XXXXXXXXX XXX XXXXX XXX XXXXX X X X X XXX XXXXXXXXXXXXXXX X X XX
X   X         X X   X X X X X         X     X X       X   X     X X X X X     X         X X X X X XX
XXXXXXXXX XXX XXX XXX XXXXX XXX XXX XXX XXXXX X XXXXX X X X XXXXXXX X XXX X XXX XXXXXXXXX X XXXXX XX
X           X       X         X   X                 X X X X     X   X   X X                   X   XX
XXXXXXXXXXXXXXXXXXXXXXXXXXXXXXXXXXXXXXXXXXXXXXXXXXXXXXXXXXXXXXXXXXXXXXXXXXXXXXXXXXXXXXXXXXXXXXXXXXXX
XXXXXXXXXXXXXXXXXXXXXXXXXXXXXXXXXXXXXXXXXXXXXXXXXXXXXXXXXXXXXXXXXXXXXXXXXXXXXXXXXXXXXXXXXXXXXXXXXXXX 